District,Local Level Name,Total family number,Total household number,Total population,Total Male,Total Female,Persons per Family,Persons per Household
Taplejung,Aathrai Tribeni Rural Municipality,2869,2735,12288,6005,6283,4.283025444405716,4.492870201096892
Taplejung,Maiwakhola Rural Municipality,2275,2178,10365,5264,5101,4.556043956043956,4.758953168044077
Taplejung,Meringden Rural Municipality,2683,2528,12040,6181,5859,4.487513976891539,4.762658227848101
Taplejung,Mikwakhola Rural Municipality,1862,1792,7991,4000,3991,4.291621911922664,4.459263392857143
Taplejung,Phaktanglung Rural Municipality,2864,2700,11925,6239,5686,4.163756983240224,4.416666666666667
Taplejung,Phungling Municipality,7306,5888,28786,14160,14626,3.9400492745688473,4.888926630434782
Taplejung,Sidingba Rural Municipality,2604,2484,10981,5593,5388,4.216973886328725,4.420692431561997
Taplejung,Sirijangha Rural Municipality,3329,3197,14186,7227,6959,4.261339741664163,4.43728495464498
Taplejung,Pathivara Yangwarak Rural Municipality,2738,2637,11797,5855,5942,4.308619430241052,4.473644292756921
Panchthar,Falelung Rural Municipality,4940,4773,20531,10211,10320,4.156072874493927,4.301487534045673
Panchthar,Falgunanda Rural Municipality,5293,4968,21253,10417,10836,4.015303230682033,4.277979066022544
Panchthar,Hilihang Rural Municipality,4878,4647,20537,10160,10377,4.210127101271013,4.419410372283194
Panchthar,Kummayak Rural Municipality,3199,3012,13020,6532,6488,4.070021881838074,4.322709163346613
Panchthar,Miklajung Rural Municipality,5509,5163,21328,10535,10793,3.8714830277727357,4.130931628897928
Panchthar,Phidim Municipality,12433,10442,48713,23963,24750,3.9180406981420415,4.6651024707910365
Panchthar,Tumbewa Rural Municipality,2752,2636,11063,5644,5419,4.019985465116279,4.196889226100152
Panchthar,Yangwarak Rural Municipality,3964,3765,16828,8509,8319,4.245206861755802,4.4695883134130145
Ilam,Chulachuli Rural Municipality,5624,5533,22856,11215,11641,4.064011379800854,4.130851256099765
Ilam,Deumai Municipality,7907,7535,31531,15807,15724,3.9877323890223852,4.184605175846052
Ilam,Fakphokthum Rural Municipality,4923,4748,20004,9800,10204,4.063375990249848,4.213142375737153
Ilam,Illam Municipality,13395,11943,50455,24781,25674,3.766703994027622,4.224650422841832
Ilam,Maijogmai Rural Municipality,4957,4881,19295,9686,9609,3.8924752874722612,3.953083384552346
Ilam,Mai Municipality,7966,7844,30988,15126,15862,3.890032638714537,3.950535441101479
Ilam,Mangsebung Rural Municipality,3891,3793,16897,8602,8295,4.342585453610897,4.454785130503559
Ilam,Rong Rural Municipality,4715,4650,17555,8739,8816,3.7232237539766704,3.775268817204301
Ilam,Sandakpur Rural Municipality,4031,3937,15460,7840,7620,3.835276606301166,3.9268478536957074
Ilam,Suryodaya Municipality,14149,13463,55457,27922,27535,3.919499611279949,4.119215628017529
Jhapa,Arjundhara Municipality,20978,18995,84429,40591,43838,4.0246448660501475,4.444801263490392
Jhapa,Barhadashi Rural Municipality,9053,8665,37916,17952,19964,4.188224897823925,4.375764570109636
Jhapa,Bhadrapur Municipality,17385,16032,70823,33988,36835,4.073799252228933,4.417602295409182
Jhapa,Birtamod Municipality,29861,23039,117355,57136,60219,3.9300425303908106,5.093754069187031
Jhapa,Buddhashanti Rural Municipality,13276,12518,52911,25276,27635,3.9854624887014163,4.226793417478831
Jhapa,Damak Municipality,27725,22000,107410,51118,56292,3.874120829576195,4.882272727272727
Jhapa,Gauradhaha Municipality,14845,14137,60598,28782,31816,4.0820478275513645,4.286482280540426
Jhapa,Gauriganj Rural Municipality,8712,8069,36058,17089,18969,4.138888888888889,4.46870739868633
Jhapa,Haldibari Rural Municipality,7894,7621,33054,15831,17223,4.187230808208766,4.33722608581551
Jhapa,Jhapa Rural Municipality,8554,8003,39372,19131,20241,4.602758943184475,4.919655129326503
Jhapa,Kachankawal Rural Municipality,10200,9260,42386,20024,22362,4.155490196078431,4.5773218142548595
Jhapa,Kamal Rural Municipality,13356,12335,53710,25739,27971,4.021413596885295,4.354276449128496
Jhapa,Kankai Municipality,13553,12419,53088,25557,27531,3.9170663321773778,4.274740317255818
Jhapa,Mechinagar Municipality,32710,29865,131520,64410,67110,4.020788749617854,4.4038171772978405
Jhapa,Shivasataxi Municipality,18036,17031,73460,34872,38588,4.072965180749612,4.313311021079208
Morang,Belbari Municipality,20662,18945,81837,38460,43377,3.9607492014325816,4.319714964370546
Morang,Biratnagar Metropolitian City,57383,45204,244750,122769,121981,4.265200494920098,5.414343863374922
Morang,Budhiganga Rural Municipality,12455,10768,51640,25472,26168,4.146126053793657,4.7956909361069835
Morang,Dhanpalthan Rural Municipality,9935,8528,45204,22136,23068,4.5499748364368395,5.300656660412758
Morang,Gramthan Rural Municipality,9483,8660,36500,17889,18611,3.848992934725298,4.214780600461894
Morang,Jahada Rural Municipality,9868,8489,47836,24262,23574,4.847588163761654,5.635057132760043
Morang,Kanepokhari Rural Municipality,10760,10271,43177,20441,22736,4.012732342007435,4.20377762632655
Morang,Katahari Rural Municipality,10522,9370,48633,24414,24219,4.622030032313249,5.190288153681964
Morang,Kerabari Rural Municipality,8809,8184,34725,16768,17957,3.941991145419457,4.243035190615836
Morang,Letang Municipality,9304,8758,38675,18473,20202,4.156814273430783,4.415962548527061
Morang,Miklajung Rural Municipality,8390,7969,33315,16074,17241,3.970798569725864,4.180574727067386
Morang,Patahrishanishchare Municipality,18191,16621,72689,34263,38426,3.995877082073553,4.37332290475904
Morang,Rangeli Municipality,13339,11903,57814,28238,29576,4.334207961616313,4.8570948500378055
Morang,Ratuwamai Municipality,14624,13768,61355,29091,32264,4.195500547045952,4.456348053457292
Morang,Sundarharaicha Municipality,30219,26677,121305,57858,63447,4.014196366524372,4.547175469505566
Morang,Sunwarshi Municipality,12889,11401,56169,27092,29077,4.357902087050974,4.926673098850978
Morang,Uralabari Municipality,17818,15899,71562,33827,37735,4.016275676282411,4.501037801119567
Sunsari,Barahchhetra Municipality,21961,20781,91891,43178,48713,4.184281225809389,4.421875751888744
Sunsari,Barju Rural Municipality,8034,6867,36533,18571,17962,4.547298979337814,5.320081549439347
Sunsari,Bhokraha Narsing Rural Municipality,9299,8155,49371,24501,24870,5.30928056780299,6.0540772532188845
Sunsari,Dewanganj Rural Municipality,7814,6526,39367,19710,19657,5.038008702329153,6.032332209623046
Sunsari,Dharan Sub-Metropolitian City,43815,34834,173096,82683,90413,3.950610521510898,4.96916805419992
Sunsari,Duhabi Municipality,15415,12410,67051,33448,33603,4.349724294518326,5.402981466559226
Sunsari,Gadhi Rural Municipality,8751,7664,39478,19426,20052,4.511255856473546,5.151096033402923
Sunsari,Harinagar Rural Municipality,8765,7630,49501,24459,25042,5.647575584711922,6.487680209698558
Sunsari,Inaruwa Municipality,16931,15044,75920,37273,38647,4.48408245230642,5.046530178144111
Sunsari,Itahari Sub-Metropolitian City,50743,40207,198098,94308,103790,3.9039473424905897,4.926953018131171
Sunsari,Koshi Rural Municipality,9377,7634,48768,24550,24218,5.200810493761331,6.388263033796175
Sunsari,Ramdhuni Municipality,15969,14025,63378,29980,33398,3.9688145782453503,4.518930481283422
Dhankuta,Chaubise Rural Municipality,4493,4233,17914,8764,9150,3.987091030491876,4.231986770611859
Dhankuta,Chhathar Jorpati Rural Municipality,4143,3932,16477,7976,8501,3.977069756215303,4.190488301119023
Dhankuta,Dhankuta Municipality,9803,8087,36156,17387,18769,3.6882586963174537,4.4708791888215655
Dhankuta,Shahidbhumi Rural Municipality,4109,4079,17784,8807,8977,4.328060355317596,4.359892130424123
Dhankuta,Mahalaxmi Municipality,5434,5251,22196,10862,11334,4.084652189915348,4.227004380118073
Dhankuta,Pakhribas Municipality,4881,4644,19256,9247,10009,3.945093218602745,4.146425495262704
Dhankuta,Sangurigadhi Rural Municipality,5025,4860,19601,9626,9975,3.900696517412935,4.033127572016461
Terhathum,Aathrai Rural Municipality,4427,4223,18210,8996,9214,4.113395075672012,4.312100402557424
Terhathum,Chhathar Rural Municipality,3509,3390,14245,6960,7285,4.059561128526646,4.202064896755163
Terhathum,Laligurans Municipality,3773,3439,15418,7482,7936,4.086403392525842,4.4832800232625765
Terhathum,Menchayam Rural Municipality,1708,1620,6698,3272,3426,3.921545667447307,4.1345679012345675
Terhathum,Myanglung Municipality,4934,4163,19078,9347,9731,3.866639643291447,4.582752822483786
Terhathum,Phedap Rural Municipality,3671,3517,15236,7506,7730,4.150367747207845,4.332101222632926
Sankhuwasabha,Bhotkhola Rural Municipality,1717,1677,6509,3256,3253,3.790914385556203,3.881335718545021
Sankhuwasabha,Chainpur Municipality,6690,6201,27078,13210,13868,4.047533632286996,4.366715045960329
Sankhuwasabha,Chichila Rural Municipality,1672,1583,6720,3351,3369,4.019138755980861,4.245104232469994
Sankhuwasabha,Dharmadevi Municipality,4071,3906,16300,7890,8410,4.003930238270695,4.173067076292883
Sankhuwasabha,Khandbari Municipality,9333,8151,36102,17967,18135,3.8682095789135325,4.42914979757085
Sankhuwasabha,Madi Municipality,3288,3169,13428,6584,6844,4.083941605839416,4.237298832439255
Sankhuwasabha,Makalu Rural Municipality,3485,3309,13492,6920,6572,3.871449067431851,4.077364762768208
Sankhuwasabha,Panchakhapan Municipality,4010,3897,16391,8060,8331,4.087531172069825,4.206055940467026
Sankhuwasabha,Sabhapokhari Rural Municipality,2533,2362,10005,5012,4993,3.9498618239242007,4.235817104149026
Sankhuwasabha,Silichong Rural Municipality,2501,2427,10432,5223,5209,4.171131547381048,4.298310671611042
Bhojpur,Aamchowk Rural Municipality,3566,3472,15237,7517,7720,4.27285473920359,4.388536866359447
Bhojpur,Arun Rural Municipality,3582,3487,14853,7247,7606,4.146566164154104,4.259535417264124
Bhojpur,Bhojpur Municipality,6775,6078,26126,12676,13450,3.8562361623616237,4.298453438631129
Bhojpur,Hatuwagadhi Rural Municipality,4040,3987,16302,8030,8272,4.035148514851485,4.088788562829195
Bhojpur,Pauwadungma Rural Municipality,2933,2866,12170,5851,6319,4.149335151721787,4.246336357292393
Bhojpur,Ramprasad Rai Rural Municipality,3700,3627,15632,7741,7891,4.224864864864865,4.309897987317342
Bhojpur,Salpasilichho Rural Municipality,3019,2972,12229,6008,6221,4.050679032792315,4.114737550471063
Bhojpur,Shadananda Municipality,7450,7139,29777,14681,15096,3.9969127516778524,4.1710323574730355
Bhojpur,Temkemaiyung Rural Municipality,3855,3773,15491,7611,7880,4.0184176394293125,4.105751391465677
Solukhumbu,Thulung Dudhkoshi Rural Municipality,4672,4568,18459,9225,9234,3.950984589041096,4.040936952714536
Solukhumbu,Maapya Dudhkoshi Rural Municipality,3142,3102,12746,6422,6324,4.0566518141311265,4.108961960025789
Solukhumbu,Khumbupasanglahmu Rural Municipality,2611,2341,9226,4737,4489,3.5335120643431637,3.94105083297736
Solukhumbu,Likhupike Rural Municipality,1255,1255,5264,2588,2676,4.1944223107569725,4.1944223107569725
Solukhumbu,Mahakulung Rural Municipality,2909,2885,11971,5921,6050,4.115159848745273,4.149393414211438
Solukhumbu,Nechasalyan Rural Municipality,2662,2631,10828,5325,5503,4.067618332081142,4.115545419992398
Solukhumbu,Solududhakunda Municipality,6830,6335,27013,13700,13313,3.9550512445095167,4.264088397790055
Solukhumbu,Sotang Rural Municipality,2321,2271,9261,4711,4550,3.990090478242137,4.077939233817702
Okhaldhunga,Champadevi Rural Municipality,4040,3977,16528,8146,8382,4.091089108910891,4.155896404324868
Okhaldhunga,Chisankhugadhi Rural Municipality,3346,3321,13761,6711,7050,4.1126718469814705,4.143631436314363
Okhaldhunga,Khijidemba Rural Municipality,3496,3461,15867,7926,7941,4.538615560640732,4.584513146489454
Okhaldhunga,Likhu Rural Municipality,3189,3125,11930,5912,6018,3.7409846346817184,3.8176
Okhaldhunga,Manebhanjyang Rural Municipality,4855,4795,19883,9626,10257,4.095365602471679,4.146611053180396
Okhaldhunga,Molung Rural Municipality,4173,4116,16944,8464,8480,4.06038820992092,4.11661807580175
Okhaldhunga,Siddhicharan Municipality,7173,6957,27977,13554,14423,3.900320646870208,4.0214172775621675
Okhaldhunga,Sunkoshi Rural Municipality,4417,4359,18024,8983,9041,4.080597690740322,4.134893324156916
Khotang,Ainselukhark Rural Municipality,3506,3421,13581,6713,6868,3.8736451796919567,3.9698918444899154
Khotang,Barahapokhari Rural Municipality,2591,2540,11461,5713,5748,4.423388653029718,4.5122047244094485
Khotang,Diprung Chuichumma Rural Municipality,3848,3780,16549,8139,8410,4.300675675675675,4.378042328042328
Khotang,Halesi Tuwachung Municipality,6149,5948,27274,13434,13840,4.435517970401691,4.585406859448554
Khotang,Jantedhunga Rural Municipality,2765,2713,12066,5934,6132,4.363833634719711,4.4474751197935865
Khotang,Kepilasagadhi Rural Municipality,3346,3237,13339,6583,6756,3.9865511057979677,4.120790855730615
Khotang,Khotehang Rural Municipality,4149,4056,16952,8417,8535,4.085803808146541,4.17948717948718
Khotang,Rawa Besi Rural Municipality,2724,2646,11218,5424,5794,4.118208516886931,4.239606953892668
Khotang,Diktel Rupakot Majhuwagadhi Municipality,10719,9775,43295,21345,21950,4.0390894673010544,4.429156010230179
Khotang,Sakela Rural Municipality,2307,2276,9605,4819,4786,4.1634156913740785,4.2201230228471
Udayapur,Belaka Municipality,12170,11633,51458,24631,26827,4.2282662284305665,4.423450528668443
Udayapur,Chaudandigadhi Municipality,12857,12162,53537,25389,28148,4.164035155946177,4.401989804308502
Udayapur,Katari Municipality,14296,12843,60168,29250,30918,4.208729714605484,4.684886708712917
Udayapur,Rautamai Rural Municipality,4586,4434,20418,10017,10401,4.452245965983428,4.604871447902571
Udayapur,Limchungbung Rural Municipality,2257,2229,9789,4837,4952,4.337173238812583,4.391655450874832
Udayapur,Tapli Rural Municipality,2884,2843,13377,6648,6729,4.638349514563107,4.705240942666197
Udayapur,Triyuga Municipality,25928,23138,104375,49514,54861,4.025570811477939,4.510977612585357
Udayapur,Udayapurgadhi Rural Municipality,6810,6650,28929,14093,14836,4.248017621145374,4.350225563909774
Saptari,Agnisair Krishna Savaran Rural Municipality,6726,6092,32047,15735,16312,4.764644662503717,5.260505581089954
Saptari,Balan Bihul Rural Municipality,5004,3770,24059,12169,11890,4.8079536370903275,6.381697612732095
Saptari,Rajgadh Rural Municipality,6942,5687,32975,16564,16411,4.7500720253529245,5.798311939511166
Saptari,Bishnupur Rural Municipality,5780,5007,28072,14230,13842,4.856747404844291,5.606550828839625
Saptari,Bode Barsain Municipality,9854,7988,46343,23092,23251,4.70296326364928,5.801577366049074
Saptari,Chhinnamasta Rural Municipality,6373,4747,30664,15416,15248,4.8115487211674255,6.45965873183063
Saptari,Dakneshwori Municipality,10094,7954,48314,24055,24259,4.786407766990291,6.074176514961026
Saptari,Hanumannagar Kankalini Municipality,11130,8680,51926,26330,25596,4.665408805031446,5.982258064516129
Saptari,Kanchanrup Municipality,12662,10277,58882,28949,29933,4.65029221292055,5.729493042716746
Saptari,Khadak Municipality,11355,9432,54193,26139,28054,4.77261118450022,5.745653095843935
Saptari,Mahadeva Rural Municipality,6522,5322,31048,15737,15311,4.760502913216805,5.833897031191282
Saptari,Rajbiraj Municipality,15121,13062,71946,36942,35004,4.758018649560214,5.508038585209003
Saptari,Rupani Rural Municipality,6963,5801,30064,14806,15258,4.317679161281057,5.182554731942768
Saptari,Saptakoshi Rural Municipality,5305,4624,23891,11632,12259,4.503487276154571,5.16673875432526
Saptari,Shambhunath Municipality,8824,7388,39423,18943,20480,4.467701722574796,5.336085544125609
Saptari,Surunga Municipality,10611,8979,49668,23899,25769,4.680802940344925,5.531573671901103
Saptari,Tilathi Koiladi Rural Municipality,6874,5366,34257,17459,16798,4.98356124527204,6.384084979500559
Saptari,Tirahut Rural Municipality,5151,4148,23987,12086,11901,4.656765676567657,5.782786885245901
Siraha,Arnama Rural Municipality,5208,4231,28137,13741,14396,5.402649769585254,6.650200898132829
Siraha,Aurahi Rural Municipality,5891,4092,27194,13669,13525,4.616194194534035,6.645650048875855
Siraha,Bariyarpatti Rural Municipality,5965,4475,29859,14876,14983,5.005699916177703,6.672402234636872
Siraha,Bhagawanpur Rural Municipality,4650,3553,23324,11544,11780,5.015913978494623,6.564593301435407
Siraha,Bishnupur Rural Municipality,4870,3821,22796,11303,11493,4.6809034907597535,5.965977492802931
Siraha,Dhangadhimai Municipality,11133,9657,54244,26617,27627,4.872361447947544,5.617065341203272
Siraha,Golbazar Municipality,13214,10853,65263,32258,33005,4.938928409262903,6.013360361190454
Siraha,Kalyanpur Municipality,12491,9869,59986,28789,31197,4.802337683131855,6.0782247441483435
Siraha,Karjanha Municipality,8440,6696,38940,18965,19975,4.613744075829384,5.815412186379929
Siraha,Lahan Municipality,21488,17832,102955,51063,51892,4.791278853313477,5.773609241812472
Siraha,Laxmipur Patari Rural Municipality,6666,5235,31103,14912,16191,4.665916591659166,5.941356255969437
Siraha,Mirchaiya Municipality,12905,10496,60086,30054,30032,4.656024796590469,5.724657012195122
Siraha,Naraha Rural Municipality,4419,3787,23656,12319,11337,5.353247341027382,6.246633218906786
Siraha,Nawarajpur Rural Municipality,4268,3214,20832,10214,10618,4.880974695407685,6.481642812694462
Siraha,Sakhuwanankarkatti Rural Municipality,4263,3223,20951,10230,10721,4.914614121510673,6.500465404902265
Siraha,Siraha Municipality,19810,15310,96543,47306,49237,4.873447753659768,6.30587851077727
Siraha,Sukhipur Municipality,8912,7192,42547,21189,21358,4.774124775583483,5.915878754171302
Dhanusa,Aaurahi Rural Municipality,4846,4036,24338,11773,12565,5.022286421791168,6.030227948463826
Dhanusa,Bateshwor Rural Municipality,4766,3903,21473,10670,10803,4.505455308434746,5.50166538560082
Dhanusa,Bideha Municipality,7764,6156,37881,18446,19435,4.879057187017001,6.1535087719298245
Dhanusa,Chhireshwornath Municipality,10826,8913,53031,26708,26323,4.898485128394605,5.949848535846517
Dhanusa,Dhanauji Rural Municipality,4683,3704,21960,10481,11479,4.689301729660474,5.928725701943844
Dhanusa,Dhanusadham Municipality,10959,9216,53035,26337,26698,4.839401405237704,5.754665798611111
Dhanusa,Ganeshman Charnath Municipality,9400,8139,44900,21982,22918,4.776595744680851,5.516648236884138
Dhanusa,Hansapur Municipality,8958,7336,44929,21997,22932,5.01551685644117,6.124454743729553
Dhanusa,Janaknandani Rural Municipality,5627,4480,28267,13556,14711,5.023458325928559,6.309598214285714
Dhanusa,Janakpurdham Sub-Metropolitian City,41941,32612,195438,100417,95021,4.65983166829594,5.992824727094321
Dhanusa,Kamala Municipality,9160,7332,45477,22103,23374,4.964737991266375,6.20253682487725
Dhanusa,Lakshminiya Rural Municipality,6609,5409,33212,16161,17051,5.025268573157815,6.1401368090220005
Dhanusa,Mithila Bihari Municipality,7651,6094,38008,18830,19178,4.9677166383479285,6.236954381358713
Dhanusa,Mithila Municipality,10522,9159,47408,23715,23693,4.505607298992587,5.1761109291407355
Dhanusa,Mukhiyapatti Musarmiya Rural Municipality,5585,4467,29351,14937,14414,5.255326768128917,6.5706290575330195
Dhanusa,Nagarain Municipality,7962,6426,37949,18682,19267,4.766264757598593,5.905539993775288
Dhanusa,Sabaila Municipality,12279,10144,62510,30630,31880,5.090805440182425,6.162263406940063
Dhanusa,Sahidnagar Municipality,11288,8944,53546,26387,27159,4.743621545003544,5.986806797853309
Mahottari,Aurahi Municipality,7841,6376,40834,20496,20338,5.207754112995791,6.404328732747804
Mahottari,Balwa Municipality,10052,8139,50031,24606,25425,4.977218463987266,6.147069664577958
Mahottari,Bardibas Municipality,15938,13635,68353,34179,34174,4.288681139415234,5.013054638797213
Mahottari,Bhangaha Municipality,11336,9017,56570,27508,29062,4.9902964008468595,6.273705223466785
Mahottari,Ekdanra Rural Municipality,6000,4735,32060,16099,15961,5.343333333333334,6.770855332629356
Mahottari,Gaushala Municipality,16090,13367,73008,36367,36641,4.537476693598508,5.4618089324455745
Mahottari,Jaleswor Municipality,13685,10607,63501,31620,31881,4.640189989039094,5.986706891675309
Mahottari,Loharpatti Municipality,9627,7658,46336,22359,23977,4.813129739274956,6.050665970227214
Mahottari,Mahottari Rural Municipality,6845,5430,32652,16211,16441,4.7701972242512785,6.0132596685082875
Mahottari,Manra Siswa Municipality,9343,7691,49126,24418,24708,5.2580541581933,6.387465869197763
Mahottari,Matihani Municipality,7356,5748,36063,17620,18443,4.90252854812398,6.274008350730689
Mahottari,Pipra Rural Municipality,8514,6459,39500,19764,19736,4.639417430115104,6.115497755070444
Mahottari,Ramgopalpur Municipality,6921,5630,36594,18240,18354,5.2873862158647595,6.499822380106572
Mahottari,Samsi Rural Municipality,7100,5478,38676,18818,19858,5.447323943661972,7.0602409638554215
Mahottari,Sonama Rural Municipality,9252,7524,51736,26647,25089,5.591872027669693,6.876129718234981
Sarlahi,Bagmati Municipality,10785,9960,45459,22454,23005,4.215020862308762,4.5641566265060245
Sarlahi,Balara Municipality,9118,6760,47602,24635,22967,5.220662425970607,7.041715976331361
Sarlahi,Barahathawa Municipality,16257,13540,83257,42271,40986,5.1213015931598695,6.148966026587888
Sarlahi,Basbariya Rural Municipality,4675,3908,26406,13495,12911,5.648342245989305,6.756908904810645
Sarlahi,Bishnu Rural Municipality,4784,3587,25870,13350,12520,5.407608695652174,7.212155004181768
Sarlahi,Bramhapuri Rural Municipality,5383,4048,27878,13831,14047,5.178896526100687,6.886857707509882
Sarlahi,Chakraghatta Rural Municipality,5041,4150,29166,15057,14109,5.785756794286848,7.0279518072289155
Sarlahi,Chandranagar Rural Municipality,6808,5320,37517,19111,18406,5.51072267920094,7.052067669172932
Sarlahi,Dhankaul Rural Municipality,5121,4077,28500,14688,13812,5.565319273579379,6.990434142752023
Sarlahi,Godaita Municipality,9510,7919,54346,27841,26505,5.714616193480547,6.862735193837605
Sarlahi,Haripur Municipality,8445,7041,43609,21546,22063,5.1638839550029605,6.193580457321403
Sarlahi,Haripurwa Municipality,6854,5210,36523,18469,18054,5.328713160198424,7.0101727447216895
Sarlahi,Hariwan Municipality,11120,9984,51333,25283,26050,4.616276978417266,5.1415264423076925
Sarlahi,Ishworpur Municipality,13776,11907,68626,34124,34502,4.981562137049942,5.763500461913161
Sarlahi,Kabilasi Municipality,8150,6702,44688,22487,22201,5.4831901840490795,6.667860340196956
Sarlahi,Kaudena Rural Municipality,5805,4478,29226,14638,14588,5.034625322997416,6.5265743635551585
Sarlahi,Lalbandi Municipality,15960,13905,67507,33555,33952,4.229761904761904,4.854872348076231
Sarlahi,Malangawa Municipality,10305,7918,53204,27167,26037,5.162930616205726,6.719373579186663
Sarlahi,Parsa Rural Municipality,4656,3625,24039,12262,11777,5.163015463917525,6.631448275862069
Sarlahi,Ramnagar Rural Municipality,5853,4373,31687,16335,15352,5.413804886383051,7.24605533958381
Rautahat,Baudhimai Municipality,6091,4899,39348,20260,19088,6.460022984731571,8.031843233312921
Rautahat,Brindaban Municipality,8237,6751,50144,24994,25150,6.087653271822266,7.427640349577841
Rautahat,Chandrapur Municipality,17237,15034,83350,41245,42105,4.835528224168939,5.544100039909538
Rautahat,Dewahhi Gonahi Municipality,6340,4990,38808,19561,19247,6.121135646687697,7.777154308617234
Rautahat,Durga Bhagwati Rural Municipality,4136,3369,23226,11809,11417,5.615570599613153,6.8940338379341055
Rautahat,Gadhimai Municipality,7850,6306,49642,25191,24451,6.3238216560509555,7.872185220424992
Rautahat,Garuda Municipality,9765,7796,60009,30685,29324,6.14531490015361,7.697408927655208
Rautahat,Gaur Municipality,7743,6062,40368,20655,19713,5.213483146067416,6.659188386671065
Rautahat,Gujara Municipality,9682,7989,54089,26391,27698,5.586552365213799,6.770434347227438
Rautahat,Ishanath Municipality,8084,6289,53402,26821,26581,6.605888174171202,8.491334075369693
Rautahat,Katahariya Municipality,7789,5933,47455,24148,23307,6.092566439851072,7.998483060846115
Rautahat,Madhav Narayan Municipality,7081,5575,40974,20953,20021,5.786470837452337,7.349596412556054
Rautahat,Maulapur Municipality,5428,4164,32468,16702,15766,5.981577008106116,7.79731027857829
Rautahat,Paroha Municipality,7214,5656,46749,23068,23681,6.480316052120876,8.265381895332391
Rautahat,Phatuwa Bijayapur Municipality,7777,6323,44358,21882,22476,5.703741802751704,7.015340819231377
Rautahat,Rajdevi Municipality,5919,4600,33836,16923,16913,5.716506166582193,7.355652173913043
Rautahat,Rajpur Municipality,8254,6205,54372,26939,27433,6.58735158710928,8.762610797743754
Rautahat,Yemunamai Rural Municipality,4728,3622,28607,14042,14565,6.050549915397631,7.89812258420762
Bara,Adarshkotwal Rural Municipality,5196,4217,29586,15141,14445,5.693995381062356,7.0158880720891625
Bara,Baragadhi Rural Municipality,5118,4071,29836,15164,14672,5.829620945681907,7.3289118152788015
Bara,Bishrampur Rural Municipality,4310,3678,23891,12535,11356,5.543155452436195,6.495649809679174
Bara,Devtal Rural Municipality,3936,3143,25082,13388,11694,6.372459349593496,7.980273623926185
Bara,Jitpur Simara Sub-Metropolitian City,23677,19848,119148,60461,58687,5.032225366389323,6.003022974607013
Bara,Kalaiya Sub-Metropolitian City,23760,19810,141179,72540,68639,5.941877104377104,7.126653205451792
Bara,Karaiyamai Rural Municipality,5154,4026,29045,14583,14462,5.6354287931703535,7.214356681569797
Bara,Kolhabi Municipality,11495,9728,46200,22362,23838,4.019138755980861,4.749177631578948
Bara,Mahagadhimai Municipality,9952,8020,59744,30717,29027,6.003215434083601,7.4493765586034915
Bara,Nijgadh Municipality,8455,7931,36591,18006,18585,4.3277350680070965,4.6136678855125455
Bara,Pacharauta Municipality,6402,5128,40252,20468,19784,6.287410184317401,7.849453978159127
Bara,Parwanipur Rural Municipality,3664,2975,22466,11767,10699,6.131550218340611,7.551596638655462
Bara,Pheta Rural Municipality,5195,4414,28922,14888,14034,5.567276227141482,6.55233348436792
Bara,Prasauni Rural Municipality,3400,2924,21747,11146,10601,6.396176470588236,7.437414500683994
Bara,Simraungadh Municipality,9064,7645,53103,27378,25725,5.858671668137688,6.946108567691302
Bara,Suwarna Rural Municipality,5584,4743,35875,18528,17347,6.424606017191977,7.563778199451824
Parsa,Bahudaramai Municipality,7058,5721,43780,22801,20979,6.202890337206007,7.652508302744275
Parsa,Bindabasini Rural Municipality,3832,3210,24466,12637,11829,6.384655532359082,7.621806853582554
Parsa,Birgunj Metropolitian City,47218,36697,268273,139849,128424,5.681583294506332,7.310488595798022
Parsa,Chhipaharmai Rural Municipality,4316,3698,26742,13732,13010,6.196014828544949,7.231476473769606
Parsa,Dhobini Rural Municipality,3585,3063,22846,11803,11043,6.372663877266388,7.458700620306889
Parsa,Jagarnathpur Rural Municipality,5846,4960,32737,16537,16200,5.5998973657201505,6.600201612903226
Parsa,Jirabhawani Rural Municipality,5287,4280,22602,11200,11402,4.275014185738604,5.280841121495327
Parsa,Kalikamai Rural Municipality,3788,3099,23740,12232,11508,6.267159450897571,7.6605356566634395
Parsa,Pakahamainpur Rural Municipality,3825,3406,22957,12073,10884,6.001830065359477,6.740164415736935
Parsa,Parsagadhi Municipality,8002,6653,41477,21023,20454,5.183329167708073,6.234330377273411
Parsa,Paterwasugauli Rural Municipality,4850,3851,25508,12866,12642,5.259381443298969,6.623734095040249
Parsa,Pokhariya Municipality,6614,5504,38985,20285,18700,5.894315089204717,7.083030523255814
Parsa,SakhuwaPrasauni Rural Municipality,6382,5244,35712,17890,17822,5.595738013162018,6.810068649885584
Parsa,Thori Rural Municipality,4546,4333,17494,8346,9148,3.8482182138143424,4.037387491345488
Sindhuli,Dudhouli Municipality,16231,14869,70679,34227,36452,4.354568418458506,4.753446768444414
Sindhuli,Ghanglekh Rural Municipality,2875,2801,12701,6214,6487,4.417739130434782,4.534451981435201
Sindhuli,Golanjor Rural Municipality,4537,4340,19012,9296,9716,4.1904342076261845,4.380645161290323
Sindhuli,Hariharpurgadhi Rural Municipality,5298,5199,26829,13132,13697,5.063986409966025,5.160415464512406
Sindhuli,Kamalamai Municipality,18238,15913,71811,34922,36889,3.937438315604781,4.5127254446050395
Sindhuli,Marin Rural Municipality,6089,5843,28988,14277,14711,4.76071604532764,4.961150094129728
Sindhuli,Phikkal Rural Municipality,3091,3039,14359,7058,7301,4.645422193464898,4.724909509707141
Sindhuli,Sunkoshi Rural Municipality,5075,4920,18136,8772,9364,3.5735960591133007,3.6861788617886178
Sindhuli,Tinpatan Rural Municipality,7939,7669,35145,17429,17716,4.4268799596926565,4.582735689138088
Ramechhap,Doramba Rural Municipality,5036,4928,17529,8129,9400,3.4807386814932486,3.557021103896104
Ramechhap,Gokulganga Rural Municipality,4897,4773,18363,8826,9537,3.749846845007147,3.8472658705216847
Ramechhap,Khadadevi Rural Municipality,5507,5392,19381,9174,10207,3.519339023061558,3.5943991097922847
Ramechhap,Likhu Tamakoshi Rural Municipality,5310,5149,18675,8702,9973,3.516949152542373,3.6269178481258497
Ramechhap,Manthali Municipality,11105,10212,40230,18967,21263,3.6226924808644756,3.9394829612220916
Ramechhap,Ramechhap Municipality,6663,6456,25117,11829,13288,3.7696232928110462,3.89048946716233
Ramechhap,Sunapati Rural Municipality,4201,4100,14616,6932,7684,3.4791716258033802,3.564878048780488
Ramechhap,Umakunda Rural Municipality,4216,4063,16709,8219,8490,3.963235294117647,4.112478464189023
Dolakha,Baiteshwor Rural Municipality,5412,5212,17947,8613,9334,3.3161492978566147,3.443399846508058
Dolakha,Bhimeshwor Municipality,10265,9049,35122,16895,18227,3.4215294690696543,3.8813128522488674
Dolakha,Bigu Rural Municipality,5055,4805,16299,7853,8446,3.22433234421365,3.392091571279917
Dolakha,Gaurishankar Rural Municipality,4667,4612,15982,7889,8093,3.42446968073709,3.4653078924544665
Dolakha,Jiri Municipality,4102,3959,15500,7530,7970,3.778644563627499,3.9151300833543825
Dolakha,Kalinchok Rural Municipality,6268,6046,21210,10354,10856,3.383854499042757,3.5081045319219317
Dolakha,Melung Rural Municipality,4877,4759,16051,7571,8480,3.2911625999589913,3.372767388106745
Dolakha,Sailung Rural Municipality,5248,5088,18328,9048,9280,3.4923780487804876,3.602201257861635
Dolakha,Tamakoshi Rural Municipality,4759,4317,15237,7369,7868,3.201723051061147,3.5295343988881167
Sindhupalchok,Barhabise Municipality,6994,6677,24158,11980,12178,3.454103517300543,3.6180919574659276
Sindhupalchok,Balefi Rural Municipality,4730,4467,16465,8062,8403,3.480972515856237,3.685918961271547
Sindhupalchok,Bhotekoshi Rural Municipality,3769,3622,14239,7259,6980,3.7779251790925974,3.931253451131971
Sindhupalchok,Chautara SangachokGadhi Municipality,11936,11111,42962,20356,22606,3.59936327077748,3.8666186661866617
Sindhupalchok,Helambu Rural Municipality,4755,4589,17723,8907,8816,3.7272344900105154,3.862061451296579
Sindhupalchok,Indrawati Rural Municipality,6812,6584,25518,12114,13404,3.7460364063417497,3.8757594167679223
Sindhupalchok,Jugal Rural Municipality,4698,4549,19148,9657,9491,4.075776926351639,4.209276764123984
Sindhupalchok,Lisangkhu Pakhar Rural Municipality,3746,3605,11560,5713,5847,3.0859583555792844,3.206657420249653
Sindhupalchok,Melamchi Municipality,11349,10811,41170,20073,21097,3.6276323905189884,3.8081583572287485
Sindhupalchok,Panchpokhari Thangpal Rural Municipality,5917,5634,20978,10596,10382,3.5453777251985805,3.7234646787362444
Sindhupalchok,Sunkoshi Rural Municipality,4597,4509,15307,7376,7931,3.329780291494453,3.3947660235085384
Sindhupalchok,Tripurasundari Rural Municipality,3653,3551,12194,5972,6222,3.3380782918149468,3.4339622641509435
Kavrepalanchok,Banepa Municipality,16973,12545,67629,33180,34449,3.984504801743946,5.390912714228777
Kavrepalanchok,Bethanchowk Rural Municipality,3900,3730,14996,7229,7767,3.845128205128205,4.020375335120644
Kavrepalanchok,Bhumlu Rural Municipality,4524,4407,15858,7607,8251,3.5053050397877983,3.5983662355343773
Kavrepalanchok,Chaurideurali Rural Municipality,4181,4084,14106,6668,7438,3.3738340110021525,3.453966699314398
Kavrepalanchok,Dhulikhel Municipality,8808,7309,36183,18501,17682,4.107970027247957,4.950472020796279
Kavrepalanchok,Khanikhola Rural Municipality,2484,2455,12375,6131,6244,4.981884057971015,5.040733197556008
Kavrepalanchok,Mahabharat Rural Municipality,3327,3297,16148,7933,8215,4.853621881574992,4.897785865938732
Kavrepalanchok,Mandandeupur Municipality,8220,7861,31261,15335,15926,3.8030413625304136,3.9767205190179364
Kavrepalanchok,Namobuddha Municipality,7406,6988,26280,12579,13701,3.548474210099919,3.7607326846021754
Kavrepalanchok,Panauti Municipality,12986,11555,52078,25457,26621,4.010318804866779,4.506966681090437
Kavrepalanchok,Panchkhal Municipality,9295,8783,35992,17471,18521,3.872189349112426,4.0979164294660135
Kavrepalanchok,Roshi Rural Municipality,6148,6039,23551,11458,12093,3.83067664281067,3.8998178506375227
Kavrepalanchok,Temal Rural Municipality,4930,4872,16959,8197,8762,3.4399594320486817,3.480911330049261
Lalitpur,Bagmati Rural Municipality,2800,2735,11196,5637,5559,3.9985714285714287,4.093601462522852
Lalitpur,Godawari Municipality,24771,20966,100972,49707,51265,4.076218158330305,4.815987789754841
Lalitpur,Konjyosom Rural Municipality,2176,2148,9042,4499,4543,4.155330882352941,4.209497206703911
Lalitpur,Lalitpur Metropolitian City,77872,49044,299843,150702,149141,3.8504597287856996,6.113754995514232
Lalitpur,Mahalaxmi Municipality,31509,20659,118710,60388,58322,3.767495001428163,5.746163899511109
Lalitpur,Mahankal Rural Municipality,1878,1836,7861,3913,3948,4.185835995740149,4.281590413943355
Bhaktapur,Bhaktapur Municipality,18854,12200,78854,39664,39190,4.182348573247056,6.4634426229508195
Bhaktapur,Changunarayan Municipality,21946,17373,88612,44073,44539,4.037728971110909,5.100558337650377
Bhaktapur,Madhyapur Thimi Municipality,31768,17639,119955,60954,59001,3.7759695290858724,6.80055558705142
Bhaktapur,Suryabinayak Municipality,35885,23637,137971,68971,69000,3.8448098091124425,5.837077463299065
Kathmandu,Budhanilakantha Municipality,47169,26910,179688,89284,90404,3.809451122559308,6.67736900780379
Kathmandu,Chandragiri Municipality,36012,22070,136928,68350,68578,3.802288126180162,6.204259175351155
Kathmandu,Dakshinkali Municipality,6527,5568,26744,13179,13565,4.097441397272867,4.80316091954023
Kathmandu,Gokarneshwor Municipality,40114,19098,151200,74453,76747,3.7692576157949844,7.917059377945335
Kathmandu,Kageshwori Manahora Municipality,34794,21028,133327,66138,67189,3.8318963039604528,6.340450827468138
Kathmandu,Kathmandu Metropolitian City,231714,105649,845767,431501,414266,3.650047040748509,8.00544255033176
Kathmandu,Kirtipur Municipality,24211,12676,81782,43378,38404,3.3778860848374705,6.451719785421268
Kathmandu,Nagarjun Municipality,31323,17466,115507,57631,57876,3.6876097436388595,6.613248597274705
Kathmandu,Shankharapur Municipality,7275,6479,30414,15188,15226,4.180618556701031,4.694242938725112
Kathmandu,Tarakeshwor Municipality,41364,21623,151508,75300,76208,3.6627985688037907,7.006798316607316
Kathmandu,Tokha Municipality,37413,17239,135741,67396,68345,3.6281773715018844,7.874064620917687
Nuwakot,Belkotgadhi Municipality,9464,9244,35200,17139,18061,3.7193575655114115,3.8078753786239723
Nuwakot,Bidur Municipality,15604,13911,60111,29043,31068,3.8522814662906946,4.321112788440802
Nuwakot,Dupcheshwar Rural Municipality,5195,5023,21019,10473,10546,4.0460057747834455,4.184551065100537
Nuwakot,Kakani Rural Municipality,6388,6012,24323,11969,12354,3.807608015028178,4.045741849634065
Nuwakot,Kispang Rural Municipality,3969,3853,14122,6920,7202,3.558075081884606,3.6651959512068517
Nuwakot,Likhu Rural Municipality,4604,4374,17737,8646,9091,3.85251954821894,4.055098308184728
Nuwakot,Myagang Rural Municipality,3755,3595,12417,6086,6331,3.3067909454061253,3.453963838664812
Nuwakot,Panchakanya Rural Municipality,3629,3539,13864,6771,7093,3.820336180766051,3.9174908166148628
Nuwakot,Shivapuri Rural Municipality,4877,4795,16979,8115,8864,3.481443510354726,3.5409801876955163
Nuwakot,Suryagadhi Rural Municipality,3842,3776,14929,7256,7673,3.885736595523165,3.953654661016949
Nuwakot,Tadi Rural Municipality,4031,3867,16055,7911,8144,3.9828826593897295,4.151797258856995
Nuwakot,Tarkeshwar Rural Municipality,3792,3735,14164,6670,7494,3.7352320675105486,3.792235609103079
Rasuwa,Gosaikunda Rural Municipality,2477,2149,8043,4071,3972,3.2470730722648367,3.742671009771987
Rasuwa,Kalika Rural Municipality,2474,2412,10172,5011,5161,4.111560226354082,4.217247097844113
Rasuwa,Naukunda Rural Municipality,2899,2878,12095,6059,6036,4.1721283201103825,4.2025712300208475
Rasuwa,Amachodingmo Rural Municipality,1727,1688,6673,3486,3187,3.863925883034163,3.9531990521327014
Rasuwa,Uttargaya Rural Municipality,2264,2235,8571,4232,4339,3.7857773851590104,3.8348993288590605
Dhading,Benighat Rorang Rural Municipality,7791,6979,34473,17542,16931,4.424720831728918,4.939532884367388
Dhading,Dhunibesi Municipality,7235,6777,29126,14411,14715,4.025708362128542,4.297771875461119
Dhading,Gajuri Rural Municipality,6909,6306,28756,14471,14285,4.162107396149949,4.560101490643831
Dhading,Galchi Rural Municipality,6212,5783,24206,11875,12331,3.8966516419832584,4.185716756008992
Dhading,Gangajamuna Rural Municipality,5305,5183,19460,9494,9966,3.668237511781338,3.7545822882500484
Dhading,Jwalamukhi Rural Municipality,6116,5972,21202,9898,11304,3.4666448659254416,3.5502344273275286
Dhading,Khaniyabash Rural Municipality,2640,2618,10680,5175,5505,4.045454545454546,4.0794499618029025
Dhading,Netrawati Dabjong Rural Municipality,3295,3242,11271,5390,5881,3.420637329286798,3.4765576804441705
Dhading,Nilakantha Municipality,16579,14281,58151,27136,31015,3.5075094999698413,4.071913731531406
Dhading,Rubi Valley Rural Municipality,3005,2989,10472,5261,5211,3.4848585690515805,3.503512880562061
Dhading,Siddhalek Rural Municipality,5883,5795,22212,10652,11560,3.7756246812850587,3.8329594477998272
Dhading,Thakre Rural Municipality,7745,7142,31554,15797,15757,4.074112330535829,4.4180901708204985
Dhading,Tripura Sundari Rural Municipality,5748,5596,21188,10105,11083,3.686151704940849,3.786275911365261
Makwanpur,Bagmati Rural Municipality,6498,6195,30625,15111,15514,4.712988611880578,4.943502824858757
Makwanpur,Bakaiya Rural Municipality,9028,8664,40671,19947,20724,4.5049844926894105,4.694252077562327
Makwanpur,Bhimphedi Rural Municipality,5128,4939,21626,10668,10958,4.217238689547582,4.378619153674833
Makwanpur,Hetauda Sub-Metropolitian City,47027,39425,195951,97324,98627,4.166776532630191,4.970221940393151
Makwanpur,Indrasarowar Rural Municipality,3415,3217,13758,6739,7019,4.028696925329429,4.276655268884054
Makwanpur,Kailash Rural Municipality,4487,4400,21992,11140,10852,4.901270336527747,4.998181818181818
Makwanpur,Makawanpurgadhi Rural Municipality,5342,5239,24252,12169,12083,4.539872706851367,4.629127696125215
Makwanpur,Manahari Rural Municipality,10762,10097,47144,22986,24158,4.380598401784055,4.6691096365257
Makwanpur,Raksirang Rural Municipality,5077,5043,25871,13147,12724,5.095725822336025,5.130081300813008
Makwanpur,Thaha Municipality,9842,8995,39163,19241,19922,3.9791709002235316,4.3538632573652025
Chitawan,Bharatpur Metropolitian City,98288,77838,369377,179744,189633,3.7581088230506268,4.7454585164058685
Chitawan,Ichchhyakamana Rural Municipality,6174,5517,26965,13599,13366,4.3675089083252345,4.887620083378648
Chitawan,Kalika Municipality,12466,11623,52779,25740,27039,4.233836034012514,4.540910264131464
Chitawan,Khairahani Municipality,16757,14650,68675,33104,35571,4.098287282926538,4.687713310580205
Chitawan,Madi Municipality,10227,9710,38550,18257,20293,3.7694338515693753,3.970133882595263
Chitawan,Rapti Municipality,15459,14390,66426,32609,33817,4.296914418785174,4.616122307157749
Chitawan,Ratnanagar Municipality,22670,19901,90978,44120,46858,4.0131451257168065,4.57152906889101
Gorkha,Aarughat Rural Municipality,6220,5950,21876,10409,11467,3.517041800643087,3.676638655462185
Gorkha,Ajirkot Rural Municipality,3667,3589,13002,6389,6613,3.5456776656667577,3.6227361382000556
Gorkha,Bhimsenthapa Rural Municipality,5265,5186,17118,7819,9299,3.2512820512820513,3.3008098727342845
Gorkha,Chum Nubri Rural Municipality,2134,2036,6789,3240,3549,3.181349578256795,3.3344793713163066
Gorkha,Dharche Rural Municipality,3790,3683,14563,7025,7538,3.8424802110817944,3.9541134944338854
Gorkha,Gandaki Rural Municipality,5688,5537,21662,10414,11248,3.8083684950773558,3.91222683763771
Gorkha,Gorkha Municipality,15298,12641,53285,25279,28006,3.483135050333377,4.215251957914722
Gorkha,Palungtar Municipality,11317,10727,37274,17431,19843,3.293629053636123,3.4747832572014543
Gorkha,Sahid Lakhan Rural Municipality,6812,6554,22429,10492,11937,3.292571931884909,3.422184925236497
Gorkha,Siranchok Rural Municipality,6026,5907,19829,9352,10477,3.290574178559575,3.356864736753005
Gorkha,Barpak Sulikot Rural Municipality,6583,6426,23222,10921,12301,3.5275710162539875,3.613756613756614
Lamjung,Besishahar Municipality,11308,8781,38562,18525,20037,3.410152104704634,4.391527160915613
Lamjung,Dordi Rural Municipality,4597,4462,15639,7585,8054,3.4020013051990428,3.5049305244285076
Lamjung,Dudhpokhari Rural Municipality,2492,2470,8558,4178,4380,3.4341894060995184,3.4647773279352228
Lamjung,Kwholasothar Rural Municipality,2285,2228,8008,3827,4181,3.5045951859956235,3.594254937163375
Lamjung,MadhyaNepal Municipality,6528,6002,21373,9767,11606,3.274050245098039,3.560979673442186
Lamjung,Marsyangdi Rural Municipality,4620,4455,17267,8421,8846,3.7374458874458876,3.8758698092031425
Lamjung,Rainas Municipality,5009,4872,17207,8309,8898,3.4352166101018167,3.5318144499178983
Lamjung,Sundarbazar Municipality,8034,6831,26866,12597,14269,3.3440378391834704,3.9329527155614112
Tanahu,Anbukhaireni Rural Municipality,6284,4758,22349,10791,11558,3.5564926798217695,4.69714165615805
Tanahu,Bandipur Rural Municipality,5418,4712,19403,9251,10152,3.5812107788851977,4.1177843803056025
Tanahu,Bhanu Municipality,13064,12351,43255,19943,23312,3.311007348438457,3.5021455752570643
Tanahu,Bhimad Municipality,8964,7965,33077,15166,17911,3.689982150825524,4.15279347143754
Tanahu,Byas Municipality,24078,19547,80944,37669,43275,3.361741008389401,4.140993502839311
Tanahu,Devghat Rural Municipality,3878,3653,14941,7115,7826,3.8527591542031976,4.090062961949083
Tanahu,Ghiring Rural Municipality,4490,4102,15038,7013,8025,3.3492204899777285,3.666016577279376
Tanahu,Myagde Rural Municipality,6532,5857,23385,10781,12604,3.580067360685854,3.992658357520915
Tanahu,Rhishing Rural Municipality,4981,4611,18821,8590,10231,3.778558522385063,4.081761006289308
Tanahu,Shuklagandaki Municipality,15479,14086,55749,26023,29726,3.601589249951547,3.9577594774953857
Syangja,Aandhikhola Rural Municipality,4718,4278,14970,6916,8054,3.172954641797372,3.4992987377279103
Syangja,Arjunchaupari Rural Municipality,3810,3549,14094,6495,7599,3.6992125984251967,3.9712595097210484
Syangja,Bhirkot Municipality,6226,5644,22617,10320,12297,3.6326694506906523,4.007264351523742
Syangja,Biruwa Rural Municipality,3980,3775,13900,6571,7329,3.492462311557789,3.6821192052980134
Syangja,Chapakot Municipality,6389,5726,22787,10398,12389,3.5665988417592738,3.9795668878798462
Syangja,Galyang Municipality,7971,7226,31125,14413,16712,3.9047798268724123,4.307362302795461
Syangja,Harinas Rural Municipality,3591,3318,12979,5953,7026,3.614313561681983,3.911693791440627
Syangja,Kaligandagi Rural Municipality,4946,4666,18008,8242,9766,3.6409219571370803,3.859408486926704
Syangja,Phedikhola Rural Municipality,3222,2919,10786,5035,5751,3.3476101800124147,3.6951010620075366
Syangja,Putalibazar Municipality,12152,10390,42079,19440,22639,3.462722185648453,4.04995187680462
Syangja,Waling Municipality,13705,11365,50932,23657,27275,3.7163079168186792,4.481478222613286
Kaski,Annapurna Rural Municipality,6406,5811,22517,10863,11654,3.5149859506712455,3.874892445362244
Kaski,Machhapuchchhre Rural Municipality,6144,5509,22013,10762,11251,3.5828450520833335,3.9958250136140863
Kaski,Madi Rural Municipality,4115,4014,16318,8136,8182,3.9654921020656135,4.065271549576482
Kaski,Pokhara Metropolitian City,143137,101669,518452,250999,267453,3.622068368066957,5.099410833193993
Kaski,Rupa Rural Municipality,3674,3569,14741,7093,7648,4.012248230811105,4.130288596245447
Manang,Chame Rural Municipality,391,333,1272,728,544,3.2531969309462916,3.81981981981982
Manang,Narpa Bhumi Rural Municipality,125,125,398,170,228,3.184,3.184
Manang,Narshon Rural Municipality,471,441,1671,831,840,3.5477707006369426,3.7891156462585034
Manang,Manang Ingshyang Rural Municipality,558,548,1584,818,766,2.838709677419355,2.8905109489051095
Mustang,Waragung Muktikhsetra Rural Municipality,738,666,2611,1336,1275,3.537940379403794,3.9204204204204203
Mustang,Lo-Ghekar Damodarkunda Rural Municipality,459,444,1535,748,787,3.344226579520697,3.4572072072072073
Mustang,Gharapjhong Rural Municipality,1169,921,4875,2904,1971,4.170230966638152,5.293159609120521
Mustang,Lomanthang Rural Municipality,540,539,1997,1132,865,3.698148148148148,3.7050092764378477
Mustang,Thasang Rural Municipality,845,698,3578,2054,1524,4.234319526627219,5.126074498567335
Myagdi,Annapurna Rural Municipality,3618,3340,12351,6078,6273,3.413764510779436,3.6979041916167663
Myagdi,Beni Municipality,9465,7202,33062,15572,17490,3.493079767564712,4.590669258539295
Myagdi,Dhaulagiri Rural Municipality,3192,3008,12604,6158,6446,3.9486215538847116,4.190159574468085
Myagdi,Malika Rural Municipality,4818,4336,18346,8999,9347,3.8078040680780405,4.231088560885609
Myagdi,Mangala Rural Municipality,3934,3699,14772,7030,7742,3.754956786985257,3.9935117599351178
Myagdi,Raghuganga Rural Municipality,4174,3767,14232,6857,7375,3.409678965021562,3.7780727369259357
Parbat,Bihadi Rural Municipality,3192,3063,12521,5960,6561,3.9226190476190474,4.087822396343454
Parbat,Jaljala Rural Municipality,6095,5140,21375,10259,11116,3.5069729286300246,4.158560311284047
Parbat,Kushma Municipality,11906,9740,38774,18543,20231,3.256677305560222,3.980903490759754
Parbat,Mahashila Rural Municipality,2093,1964,8233,3867,4366,3.9335881509794555,4.191955193482689
Parbat,Modi Rural Municipality,5148,4618,18018,8611,9407,3.5,3.9016890428757036
Parbat,Painyu Rural Municipality,3292,2995,12705,6025,6680,3.859356014580802,4.242070116861436
Parbat,Phalebas Municipality,5875,5529,20726,9534,11192,3.5278297872340425,3.748598299873395
Baglung,Badigad Rural Municipality,6819,6324,28797,13487,15310,4.223053233611966,4.553605313092979
Baglung,Baglung Municipality,16399,12924,57030,26588,30442,3.4776510762851394,4.41272051996286
Baglung,Bareng Rural Municipality,2981,2796,11162,5070,6092,3.744381080174438,3.992131616595136
Baglung,Dhorpatan Municipality,7661,6535,30779,14306,16473,4.017621720402036,4.709869931140015
Baglung,Galkot Municipality,7912,7314,30503,14473,16030,3.855283114256825,4.170494941208641
Baglung,Jaimuni Municipality,6912,6555,24784,11310,13474,3.5856481481481484,3.78093058733791
Baglung,Kanthekhola Rural Municipality,5961,5743,22732,10387,12345,3.813454118436504,3.9582099947762495
Baglung,Nisikhola Rural Municipality,5711,5499,23215,10566,12649,4.064962353353178,4.221676668485179
Baglung,Taman Khola Rural Municipality,2622,2453,9795,4667,5128,3.7356979405034325,3.9930697105585
Baglung,Tara Khola Rural Municipality,2356,2302,10167,5010,5157,4.315365025466893,4.416594265855777
Nawalparasi East,Binayee Tribeni Rural Municipality,9348,8651,39201,18664,20537,4.193517329910141,4.531383655068778
Nawalparasi East,Bulingtar Rural Municipality,3569,3305,14596,7007,7589,4.089660969459232,4.416338880484115
Nawalparasi East,Baudeekali Rural Municipality,2914,2676,11339,5164,6175,3.8912148249828413,4.237294469357249
Nawalparasi East,Devchuli Municipality,14836,13127,59400,28133,31267,4.003774602318685,4.525024758132094
Nawalparasi East,Gaidakot Municipality,20701,17151,80737,38725,42012,3.900149751219748,4.707422307737158
Nawalparasi East,Hupsekot Rural Municipality,6250,5865,26861,12346,14515,4.29776,4.579880647911338
Nawalparasi East,Kawasoti Municipality,22184,19568,87176,40890,46286,3.9296790479624955,4.455028618152085
Nawalparasi East,Madhyabindu Municipality,15549,14345,61548,28291,33257,3.95832529423114,4.29055420006971
Gulmi,Chandrakot Rural Municipality,5148,4732,18751,8605,10146,3.6423853923853926,3.9625950972104818
Gulmi,Chatrakot Rural Municipality,5320,5073,19239,8601,10638,3.6163533834586468,3.7924305144884682
Gulmi,Dhurkot Rural Municipality,5405,5036,18699,8285,10414,3.4595744680851066,3.7130659253375695
Gulmi,Gulmidarbar Rural Municipality,5288,5032,19413,8490,10923,3.671142208774584,3.8579093799682034
Gulmi,Isma Rural Municipality,5013,4777,18530,8453,10077,3.69638938759226,3.8790035587188614
Gulmi,Kaligandaki Rural Municipality,3793,3640,15106,7085,8021,3.982599525441603,4.15
Gulmi,Madane Rural Municipality,5274,4961,19820,8985,10835,3.758058399696625,3.9951622656722434
Gulmi,Malika Rural Municipality,5273,5040,20173,9263,10910,3.82571591124597,4.002579365079365
Gulmi,Musikot Municipality,7135,6761,28761,13371,15390,4.030974071478626,4.253956515308387
Gulmi,Resunga Municipality,9129,6865,31677,14696,16981,3.4699309891554386,4.614275309541151
Gulmi,Ruru Rural Municipality,4691,4348,16638,7627,9011,3.5467917288424644,3.826586936522539
Gulmi,Satyawati Rural Municipality,5252,4953,19751,9056,10695,3.7606626047220106,3.98768423177872
Palpa,Bagnaskali Rural Municipality,4648,4423,16934,7683,9251,3.6432874354561102,3.8286231064888083
Palpa,Mathagadhi Rural Municipality,5840,5553,24024,11222,12802,4.1136986301369864,4.326310102647218
Palpa,Nisdi Rural Municipality,4075,3772,17629,8137,9492,4.326134969325153,4.673647932131495
Palpa,Purbakhola Rural Municipality,4138,3660,16145,7147,8998,3.901643305944901,4.41120218579235
Palpa,Rainadevi Chhahara Rural Municipality,6390,6046,23124,10491,12633,3.6187793427230046,3.8246774727092294
Palpa,Rambha Rural Municipality,4696,4339,17077,7565,9512,3.6364991482112434,3.9356994699239456
Palpa,Rampur Municipality,10821,9111,39190,17775,21415,3.6216615839571205,4.301393919438042
Palpa,Ribdikot Rural Municipality,4459,4236,15636,7195,8441,3.506615833146445,3.691218130311615
Palpa,Tansen Municipality,14865,10919,51470,23927,27543,3.462495795492768,4.713801630185914
Palpa,Tinau Rural Municipality,4326,4164,18291,8628,9663,4.228155339805825,4.392651296829971
Nawalparasi West,Bardaghat Municipality,18240,16430,75017,35180,39837,4.112774122807018,4.56585514303104
Nawalparasi West,Palhi Nandan Rural Municipality,7383,6165,40325,20662,19663,5.461871867804415,6.54095701540957
Nawalparasi West,Pratappur Rural Municipality,10753,9234,50326,25016,25310,4.680182274714033,5.450075806800953
Nawalparasi West,Ramgram Municipality,13081,11037,64150,31842,32308,4.904059322681753,5.812267826402102
Nawalparasi West,Sarawal Rural Municipality,8840,7576,42217,20691,21526,4.775678733031675,5.572465681098205
Nawalparasi West,Sunwal Municipality,17689,15871,72621,34316,38305,4.105432754819379,4.575704114422532
Nawalparasi West,Susta Rural Municipality,7892,6946,39798,19365,20433,5.042828180435884,5.729628563201842
Rupandehi,Butwal Sub-Metropolitian City,51099,36989,195054,95705,99349,3.8171784183643513,5.2732974668144585
Rupandehi,Devdaha Municipality,17582,15624,71806,33747,38059,4.0840632465021045,4.595878136200717
Rupandehi,Gaidahawa Rural Municipality,10020,8612,56529,28000,28529,5.641616766467066,6.563980492336275
Rupandehi,Kanchan Rural Municipality,10483,9828,42528,19295,23233,4.056853954020796,4.327228327228327
Rupandehi,Kotahimai Rural Municipality,7921,5939,46417,23527,22890,5.859992425198839,7.815625526182859
Rupandehi,Lumbini Sanskritik Municipality,13854,10736,88090,43706,44384,6.358452432510466,8.205104321907601
Rupandehi,Marchawari Rural Municipality,6972,5305,41058,20632,20426,5.888984509466437,7.739491046182846
Rupandehi,Mayadevi Rural Municipality,10040,8003,57341,28991,28350,5.711254980079682,7.164938148194427
Rupandehi,Omsatiya Rural Municipality,8218,6683,41080,20332,20748,4.998783158919445,6.146939997007332
Rupandehi,Rohini Rural Municipality,8096,6349,43277,21836,21441,5.3454792490118574,6.816349031343519
Rupandehi,Sainamaina Municipality,19657,17572,78477,36547,41930,3.992318258126876,4.46602549510585
Rupandehi,Sammarimai Rural Municipality,7303,5164,43300,21691,21609,5.929070245104752,8.384972889233152
Rupandehi,Siddharthanagar Municipality,16011,12329,76307,38136,38171,4.765910936231341,6.189228647903318
Rupandehi,Siyari Rural Municipality,9060,7883,45274,22100,23174,4.997130242825607,5.743244957503489
Rupandehi,Sudhdhodhan Rural Municipality,8717,7619,41472,20352,21120,4.757600091774693,5.443234020212627
Rupandehi,Tillotama Municipality,36399,30452,149657,71700,77957,4.111568999148329,4.914521213713385
Kapilbastu,Banganga Municipality,23482,21157,97114,45820,51294,4.135678391959799,4.590159285342913
Kapilbastu,Bijayanagar Rural Municipality,7144,6361,43440,21562,21878,6.080627099664054,6.829114919037887
Kapilbastu,Buddhabhumi Municipality,15581,13717,77281,37580,39701,4.959951222642963,5.633957862506379
Kapilbastu,Kapilbastu Municipality,15555,12871,89969,44505,45464,5.78392799742848,6.990055162769016
Kapilbastu,Krishnanagar Municipality,10889,8734,70969,35449,35520,6.517494719441638,8.125601099152737
Kapilbastu,Maharajgunj Municipality,9945,8084,65668,33257,32411,6.6031171442936145,8.123206333498269
Kapilbastu,Mayadevi Rural Municipality,8383,6623,57121,28014,29107,6.8139091017535485,8.624641401177714
Kapilbastu,Shivaraj Municipality,16072,13960,84454,41098,43356,5.254728720756595,6.0497134670487105
Kapilbastu,Suddhodhan Rural Municipality,8593,6770,53417,26258,27159,6.216338880484115,7.8902511078286555
Kapilbastu,Yashodhara Rural Municipality,7045,5462,45169,22030,23139,6.411497515968772,8.269681435371659
Arghakhanchi,Bhumekasthan Municipality,7891,7403,28317,12687,15630,3.588518565454315,3.8250709171957316
Arghakhanchi,Chhatradev Rural Municipality,6263,5930,21691,9676,12015,3.4633562190643463,3.6578414839797637
Arghakhanchi,Malarani Rural Municipality,6842,6501,23780,10747,13033,3.475591932183572,3.657898784802338
Arghakhanchi,Panini Rural Municipality,6214,5915,22330,10064,12266,3.5934985516575475,3.775147928994083
Arghakhanchi,Sandhikharka Municipality,12322,10261,42528,19507,23021,3.4513877617269926,4.144625280187117
Arghakhanchi,Sitganga Municipality,9541,9002,37888,17787,20101,3.971072214652552,4.208842479449011
Pyuthan,Ayirabati Rural Municipality,5145,4628,20404,9074,11330,3.9657920310981534,4.408815903197926
Pyuthan,Gaumukhi Rural Municipality,5616,5380,26000,12006,13994,4.62962962962963,4.83271375464684
Pyuthan,Jhimruk Rural Municipality,6592,6130,26491,11935,14556,4.018658980582524,4.321533442088091
Pyuthan,Mallarani Rural Municipality,4152,3743,15846,6866,8980,3.816473988439306,4.233502538071066
Pyuthan,Mandavi Rural Municipality,3904,3469,15778,7005,8773,4.041495901639344,4.548284808302104
Pyuthan,Naubahini Rural Municipality,7163,6781,32524,14916,17608,4.540555633114617,4.796342722312343
Pyuthan,Pyuthan Municipality,11500,10175,42094,18945,23149,3.6603478260869564,4.137002457002457
Pyuthan,Sarumarani Rural Municipality,4488,4125,19370,8545,10825,4.315953654188949,4.695757575757575
Pyuthan,Sworgadwary Municipality,8400,7739,32127,14041,18086,3.824642857142857,4.151311538958522
Rolpa,Pariwartan Rural Municipality,4765,4567,22001,10252,11749,4.617208814270724,4.817385592292533
Rolpa,Lungri Rural Municipality,5668,5486,26539,12348,14191,4.682251235003529,4.837586584032081
Rolpa,Madi Rural Municipality,4143,4023,18013,8431,9582,4.347815592565774,4.477504349987571
Rolpa,Rolpa Municipality,8836,7464,35644,16410,19234,4.033952014486193,4.77545551982851
Rolpa,Runtigadi Rural Municipality,6387,6055,29094,13734,15360,4.555190230155002,4.804954582989265
Rolpa,Sunil Smriti Rural Municipality,7066,6462,30523,13983,16540,4.319699971695443,4.72346022903126
Rolpa,Gangadev Rural Municipality,4474,4423,21738,10278,11460,4.858739383102369,4.914763735021479
Rolpa,Sunchhahari Rural Municipality,3607,3505,17281,8298,8983,4.790962018297755,4.930385164051355
Rolpa,Thawang Rural Municipality,2575,2345,11008,5159,5849,4.27495145631068,4.694243070362473
Rolpa,Tribeni Rural Municipality,5468,5257,23190,10941,12249,4.241038771031456,4.411261175575423
Rukum East,Bhume Rural Municipality,4194,3849,19835,9425,10410,4.729375298044826,5.153286567939724
Rukum East,Putha Uttarganga Rural Municipality,4573,3925,18954,9473,9481,4.144762737808878,4.829044585987261
Rukum East,Sisne Rural Municipality,4396,3833,18751,9122,9629,4.265468607825296,4.891990607878946
Dang,Babai Rural Municipality,7538,7171,31317,14527,16790,4.154550278588485,4.367173337052015
Dang,Banglachuli Rural Municipality,5173,4951,22877,10276,12601,4.422385462980862,4.620682690365583
Dang,Dangisharan Rural Municipality,5897,5579,23672,11436,12236,4.014244531117518,4.243054310808389
Dang,Gadhawa Rural Municipality,10084,9448,46275,22650,23625,4.5889527965093215,4.897861981371719
Dang,Ghorahi Sub-Metropolitian City,51619,45240,201079,94384,106695,3.895445475503206,4.44471706454465
Dang,Lamahi Municipality,13862,12482,58884,28257,30627,4.247871879959602,4.717513219035411
Dang,Rajpur Rural Municipality,5896,5634,28410,14171,14239,4.818521031207599,5.042598509052183
Dang,Rapti Rural Municipality,11837,10940,52158,24720,27438,4.4063529610543215,4.76764168190128
Dang,Shantinagar Rural Municipality,7137,6792,27666,12872,14794,3.8764186633039093,4.073321554770318
Dang,Tulsipur Sub-Metropolitian City,46699,41012,180734,85701,95033,3.870189939827405,4.4068565297961575
Banke,Baijanath Rural Municipality,16765,15439,70315,32739,37576,4.1941544885177455,4.554375283373275
Banke,Duduwa Rural Municipality,8112,6152,43039,21798,21241,5.305596646942801,6.995936280884266
Banke,Janki Rural Municipality,9124,7263,46536,23386,23150,5.1003945637878125,6.407269723254854
Banke,Khajura Rural Municipality,13885,12213,63749,30284,33465,4.591213539791141,5.219765823303038
Banke,Kohalpur Municipality,24346,21251,100289,48324,51965,4.119321449108683,4.719260270104936
Banke,Narainapur Rural Municipality,8680,6941,43698,21822,21876,5.034331797235023,6.2956346347788505
Banke,Nepalgunj Sub-Metropolitian City,35517,26491,166258,83311,82947,4.6810822986175635,6.27601827035597
Banke,Rapti Sonari Rural Municipality,15491,14380,67782,32015,35767,4.3755729133045,4.713630041724618
Bardiya,Badhaiyatal Rural Municipality,12736,11826,52056,24042,28014,4.0873115577889445,4.401826484018265
Bardiya,Bansagadhi Municipality,15149,13965,63400,29486,33914,4.18509472572447,4.539921231650555
Bardiya,Barbardiya Municipality,16950,15852,72892,34353,38539,4.300412979351033,4.598284128185718
Bardiya,Geruwa Rural Municipality,7788,7613,33742,15525,18217,4.33256291730868,4.432155523446736
Bardiya,Gulariya Municipality,16141,14177,74868,37086,37782,4.638374326249923,5.280948014389504
Bardiya,Madhuwan Municipality,12474,11647,51173,23570,27603,4.102372935706269,4.393663604361638
Bardiya,Rajapur Municipality,13711,13191,61431,29166,32265,4.480417183283495,4.657038890152377
Bardiya,Thakurbaba Municipality,11480,10646,49360,22853,26507,4.299651567944251,4.63648318617321
Rukum West,Aathbiskot Municipality,7603,7094,35929,17743,18186,4.725634617913982,5.064702565548351
Rukum West,Banfikot Rural Municipality,4827,4398,20940,10085,10855,4.338098197638285,4.7612551159618
Rukum West,Chaurjahari Municipality,6791,5957,29255,14170,15085,4.307907524664998,4.9110290414638245
Rukum West,Musikot Municipality,8793,7425,33871,16091,17780,3.8520413965654496,4.5617508417508414
Rukum West,Sani Bheri Rural Municipality,5313,4897,24778,12152,12626,4.663655185394316,5.059832550541148
Rukum West,Tribeni Rural Municipality,4375,4231,20466,9775,10691,4.677942857142857,4.837154337036162
Salyan,Bagchaur Municipality,7539,7212,34053,16496,17557,4.516912057302029,4.72171381031614
Salyan,Bangad Kupinde Municipality,7893,7423,33758,16237,17521,4.276954263271253,4.547756971574835
Salyan,Chhatreshwori Rural Municipality,5135,4847,21368,10115,11253,4.16124634858812,4.408500103156592
Salyan,Darma Rural Municipality,4270,4006,19998,9699,10299,4.6833723653395785,4.99201198202696
Salyan,Siddha Kumakh Rural Municipality,2892,2786,13135,6274,6861,4.541839557399723,4.714644651830581
Salyan,Kalimati Rural Municipality,4994,4734,22498,11126,11372,4.50500600720865,4.752429235318969
Salyan,Kapurkot Rural Municipality,3978,3864,17548,8410,9138,4.411261940673706,4.541407867494824
Salyan,Kumakh Rural Municipality,5582,5149,24858,12088,12770,4.4532425653887495,4.827733540493299
Salyan,Sharada Municipality,8992,8122,34684,16516,18168,3.85720640569395,4.270376754493967
Salyan,Tribeni Rural Municipality,4125,3841,16768,7992,8776,4.064969696969697,4.365529809945326
Surkhet,Barahtal Rural Municipality,6240,6059,25562,12248,13314,4.096474358974359,4.2188479947186
Surkhet,Bheriganga Municipality,11599,10524,48581,22833,25748,4.188378308474869,4.616210566324591
Surkhet,Birendranagar Municipality,39391,31847,154886,75921,78965,3.93201492726765,4.8634408264514715
Surkhet,Chaukune Rural Municipality,5358,4897,27006,13289,13717,5.040313549832027,5.514804982642434
Surkhet,Chingad Rural Municipality,3240,3066,15752,7405,8347,4.8617283950617285,5.137638617090672
Surkhet,Gurbhakot Municipality,11923,10960,49394,23162,26232,4.142749308060052,4.506751824817519
Surkhet,Lekbeshi Municipality,7475,7134,31791,14978,16813,4.252976588628763,4.456265769554247
Surkhet,Panchpuri Municipality,7979,7326,36062,17530,18532,4.519613986715127,4.922467922467923
Surkhet,Simta Rural Municipality,6121,5475,24298,10740,13558,3.9696128083646465,4.4379908675799085
Dailekh,Aathabis Municipality,6246,4951,31839,15565,16274,5.097502401536984,6.430822056150273
Dailekh,Bhagawatimai Rural Municipality,3627,3344,18366,9083,9283,5.06368899917287,5.492224880382775
Dailekh,Bhairabi Rural Municipality,4198,3755,17981,8377,9604,4.283230109575989,4.788548601864181
Dailekh,Chamunda Bindrasaini Municipality,5192,4475,26575,13044,13531,5.118451463790447,5.93854748603352
Dailekh,Dullu Municipality,9208,8353,39582,18506,21076,4.298653344917463,4.738656770022747
Dailekh,Dungeshwor Rural Municipality,3436,3163,14597,6940,7657,4.24825378346915,4.614922541890611
Dailekh,Gurans Rural Municipality,4562,4358,21284,10483,10801,4.665497588776852,4.883891693437357
Dailekh,Mahabu Rural Municipality,4021,3652,18037,8316,9721,4.485700074608307,4.938937568455641
Dailekh,Narayan Municipality,6668,5421,25803,12222,13581,3.8696760647870425,4.759822910902048
Dailekh,Naumule Rural Municipality,4517,4162,20589,10032,10557,4.558113792340048,4.946900528592023
Dailekh,Thantikandh Rural Municipality,4033,3142,18666,9107,9559,4.628316389784279,5.94080203691916
Jajarkot,Barekot Rural Municipality,3901,3485,22038,11010,11028,5.649320687003333,6.323672883787661
Jajarkot,Bheri Municipality,8962,7745,38370,18636,19734,4.281410399464405,4.954163976759199
Jajarkot,Chhedagad Municipality,7431,6888,38027,18852,19175,5.117346252186785,5.520760743321719
Jajarkot,Junichande Rural Municipality,4356,3967,23823,11979,11844,5.4690082644628095,6.0052936728006046
Jajarkot,Kuse Rural Municipality,4520,4199,23529,11636,11893,5.205530973451327,5.603477018337699
Jajarkot,Shiwalaya Rural Municipality,2820,2598,14720,7270,7450,5.219858156028369,5.665896843725943
Jajarkot,Nalagad Municipality,6064,5427,28858,14412,14446,4.758905013192612,5.317486640869726
Dolpa,Chharka Tangsong Rural Municipality,320,306,1713,839,874,5.353125,5.598039215686274
Dolpa,Dolpo Buddha Rural Municipality,543,542,2462,1206,1256,4.5340699815837935,4.5424354243542435
Dolpa,Jagadulla Rural Municipality,600,511,2581,1289,1292,4.301666666666667,5.050880626223092
Dolpa,Kaike Rural Municipality,926,715,4124,1931,2193,4.453563714902808,5.767832167832168
Dolpa,Mudkechula Rural Municipality,1206,1078,5875,2975,2900,4.871475953565506,5.449907235621521
Dolpa,Shey Phoksundo Rural Municipality,818,805,3717,1775,1942,4.5440097799511,4.6173913043478265
Dolpa,Thuli Bheri Municipality,2380,1770,10187,5113,5074,4.280252100840336,5.755367231638418
Dolpa,Tripurasundari Municipality,2636,2268,12300,6148,6152,4.666160849772383,5.423280423280423
Jumla,Chandannath Municipality,5367,4166,20973,10475,10498,3.907769703745109,5.034325492078732
Jumla,Guthichaur Rural Municipality,2451,2205,10891,5344,5547,4.443492452060384,4.939229024943311
Jumla,Hima Rural Municipality,2104,2062,12804,6388,6416,6.085551330798479,6.209505334626576
Jumla,Kanakasundari Rural Municipality,2786,2733,13687,6807,6880,4.912778176597272,5.0080497621661175
Jumla,Patrasi Rural Municipality,3374,3191,16881,8349,8532,5.0032602252519265,5.2901911626449385
Jumla,Sinja Rural Municipality,2427,2271,12744,6561,6183,5.2509270704573545,5.611624834874505
Jumla,Tatopani Rural Municipality,3321,3190,15721,7728,7993,4.7338151159289374,4.928213166144201
Jumla,Tila Rural Municipality,2666,2582,14692,7261,7431,5.510877719429858,5.690162664601084
Kalikot,Subha Kalika Rural Municipality,2769,2311,13900,6784,7116,5.01986276634164,6.014712245781047
Kalikot,Khandachakra Municipality,4132,3266,23336,11948,11388,5.647628267182962,7.1451316595223515
Kalikot,Mahawai Rural Municipality,1666,1364,8334,4072,4262,5.002400960384153,6.109970674486804
Kalikot,Naraharinath Rural Municipality,4422,3668,22414,11109,11305,5.068747173224785,6.1106870229007635
Kalikot,Pachaljharana Rural Municipality,2509,2196,13683,6837,6846,5.453567158230371,6.23087431693989
Kalikot,Palata Rural Municipality,2895,2683,17658,9018,8640,6.099481865284974,6.581438688035781
Kalikot,Raskot Municipality,3076,2836,16469,8059,8410,5.354031209362809,5.8071227080394925
Kalikot,Sanni Tribeni Rural Municipality,2352,2088,12864,6363,6501,5.469387755102041,6.160919540229885
Kalikot,Tilagufa Municipality,3135,2517,16259,8053,8206,5.186283891547049,6.459674215335717
Mugu,Chhayanath Rara Municipality,4917,4529,25692,13022,12670,5.225137278828554,5.672775447118569
Mugu,Khatyad Rural Municipality,3567,3429,19301,9840,9461,5.410989627137651,5.62875473899096
Mugu,Mugum Karmarong Rural Municipality,1399,1364,7301,3506,3795,5.218727662616154,5.352639296187683
Mugu,Soru Rural Municipality,2652,2469,14364,7080,7284,5.416289592760181,5.817739975698664
Humla,Adanchuli Rural Municipality,1481,1344,8110,4012,4098,5.476029709655638,6.034226190476191
Humla,Chankheli Rural Municipality,1196,1175,6625,3367,3258,5.539297658862877,5.638297872340425
Humla,Kharpunath Rural Municipality,1545,1330,6975,3465,3510,4.514563106796117,5.2443609022556394
Humla,Namkha Rural Municipality,868,850,4506,2304,2202,5.191244239631336,5.301176470588235
Humla,Sarkegad Rural Municipality,2211,2016,11040,5669,5371,4.993215739484397,5.476190476190476
Humla,Simkot Rural Municipality,3007,2512,12130,6101,6029,4.033920851346857,4.828821656050955
Humla,Tanjakot Rural Municipality,1176,1086,6110,3064,3046,5.195578231292517,5.626151012891344
Bajura,Badimalika Municipality,4082,3143,18432,9253,9179,4.515433610975013,5.86446070633153
Bajura,Budhiganga Municipality,4680,3875,20072,9259,10813,4.288888888888889,5.179870967741936
Bajura,Budhinanda Municipality,4317,3195,20745,10214,10531,4.805420430854761,6.492957746478873
Bajura,Khaptad Chhededaha Rural Municipality,3627,2878,19274,9326,9948,5.3140336366142815,6.697011813759556
Bajura,Gaumul Rural Municipality,1731,1588,8765,4373,4392,5.0635470826112075,5.519521410579345
Bajura,Himali Rural Municipality,2092,1716,10503,5284,5219,5.02055449330784,6.120629370629371
Bajura,Jagannath Rural Municipality,1965,1687,10205,4938,5267,5.193384223918575,6.049199762892709
Bajura,Swami Kartik Khaapar Rural Municipality,2392,2242,13013,6593,6420,5.440217391304348,5.804192685102587
Bajura,Tribeni Municipality,4036,3567,17989,8368,9621,4.457135777998018,5.0431735351836275
Bajhang,Bithadchir Rural Municipality,3273,2728,16854,8301,8553,5.149404216315307,6.178152492668621
Bajhang,Bungal Municipality,6242,5357,33487,15885,17602,5.364786927266902,6.251073361956319
Bajhang,Chabispathivera Rural Municipality,3125,2792,14515,6770,7745,4.6448,5.19878223495702
Bajhang,Durgathali Rural Municipality,2606,2282,11414,5149,6265,4.379892555640829,5.001752848378615
Bajhang,JayaPrithivi Municipality,5034,4088,21973,10560,11413,4.364918553833929,5.375
Bajhang,SaiPaal Rural Municipality,456,454,2681,1330,1351,5.879385964912281,5.905286343612334
Bajhang,Kedarseu Rural Municipality,4389,3768,21697,10000,11697,4.943495101389838,5.758227176220807
Bajhang,Khaptadchhanna Rural Municipality,3100,2453,13751,6238,7513,4.435806451612903,5.605788830004077
Bajhang,Masta Rural Municipality,2608,2519,13584,6518,7066,5.208588957055214,5.392616117506948
Bajhang,Surma Rural Municipality,1835,1593,11248,5609,5639,6.129700272479564,7.060891399874451
Bajhang,Talkot Rural Municipality,2238,2063,11858,5454,6404,5.298480786416444,5.747939893359185
Bajhang,Thalara Rural Municipality,3462,2819,15961,7104,8857,4.610340843443097,5.661936857041504
Achham,Bannigadhi Jayagadh Rural Municipality,3144,2309,13639,5887,7752,4.338104325699746,5.9068860978778694
Achham,Chaurpati Rural Municipality,4822,3960,22407,9985,12422,4.646827042720862,5.658333333333333
Achham,Dhakari Rural Municipality,4373,3501,22553,10813,11740,5.157329064715299,6.441873750357041
Achham,Kamalbazar Municipality,4590,3730,20947,9480,11467,4.563616557734205,5.615817694369973
Achham,Mangalsen Municipality,6231,4587,26843,12101,14742,4.307976247793292,5.851972967080881
Achham,Mellekh Rural Municipality,4752,3628,23096,10670,12426,4.86026936026936,6.366041896361632
Achham,Panchadewal Binayak Municipality,5432,4466,26316,12062,14254,4.844624447717231,5.892521271831616
Achham,Ramaroshan Rural Municipality,4959,3876,22676,10759,11917,4.5726961080863076,5.8503611971104235
Achham,Sanphebagar Municipality,6382,4883,25990,11965,14025,4.072391099968661,5.322547614171616
Achham,Turmakhad Rural Municipality,5277,4428,24440,11668,12772,4.63141936706462,5.519421860885275
Doti,Adharsha Rural Municipality,5449,4204,24911,11141,13770,4.571664525601028,5.925547098001903
Doti,Badikedar Rural Municipality,2984,2762,15078,7555,7523,5.052949061662199,5.459087617668357
Doti,Bogtan Foodsil Rural Municipality,3198,2774,15912,7488,8424,4.975609756097561,5.736121124729633
Doti,Dipayal Silgadi Municipality,8601,6111,36906,17884,19022,4.290896407394489,6.039273441335297
Doti,Jorayal Rural Municipality,4432,4092,20364,10251,10113,4.594765342960288,4.976539589442815
Doti,K I Singh Rural Municipality,4731,3975,20830,9130,11700,4.4028746565208206,5.240251572327044
Doti,Purbichauki Rural Municipality,5305,4095,21263,9089,12174,4.008105560791706,5.192429792429793
Doti,Sayal Rural Municipality,4311,3139,20125,9221,10904,4.668290419856182,6.411277476903472
Doti,Shikhar Municipality,7089,5654,30294,13307,16987,4.273381294964029,5.357976653696498
Kailali,Bardagoriya Rural Municipality,8639,8162,37714,17882,19832,4.365551568468573,4.620681205586866
Kailali,Bhajani Municipality,11143,10701,53795,25802,27993,4.8276945167369645,5.02710027100271
Kailali,Chure Rural Municipality,4272,4015,21437,10809,10628,5.018024344569288,5.339227895392279
Kailali,Dhangadhi Sub-Metropolitian City,46670,39249,204788,102334,102454,4.388000857081637,5.217661596473795
Kailali,Gauriganga Municipality,13693,12984,64327,29730,34597,4.697801796538378,4.954328404189772
Kailali,Ghodaghodi Municipality,18636,17796,85982,40223,45759,4.613758317235458,4.831535176444144
Kailali,Godawari Municipality,21508,19356,99973,47873,52100,4.648177422354473,5.164961768960529
Kailali,Janaki Rural Municipality,11180,10657,49835,23202,26633,4.457513416815742,4.676269118888993
Kailali,Joshipur Rural Municipality,7775,7630,37167,17788,19379,4.78032154340836,4.871166448230668
Kailali,Kailari Rural Municipality,10793,10458,50457,24485,25972,4.674974520522561,4.824727481353987
Kailali,Lamkichuha Municipality,20801,19367,90941,42795,48146,4.371953271477333,4.695667888676615
Kailali,Mohanyal Rural Municipality,4450,4226,21285,10375,10910,4.78314606741573,5.036677709417889
Kailali,Tikapur Municipality,20953,19091,90115,43354,46761,4.300816112251229,4.720287046252161
Kanchanpur,Bedkot Municipality,12780,11904,58250,27055,31195,4.557902973395931,4.893313172043011
Kanchanpur,Beldandi Rural Municipality,4727,4471,22041,9939,12102,4.662788237782949,4.929769626481772
Kanchanpur,Belauri Municipality,11154,10296,53918,25526,28392,4.833960910883988,5.236790986790987
Kanchanpur,Bhimdatta Municipality,27691,24715,123316,59400,63916,4.45328807193673,4.98952053408861
Kanchanpur,Krishnapur Municipality,15272,14217,72501,34347,38154,4.747315348349922,5.099599071534079
Kanchanpur,Laljhadi Rural Municipality,4822,4666,25271,12282,12989,5.240771464122771,5.41598799828547
Kanchanpur,Dodhara Chandani Municipality,9657,8891,43486,19254,24232,4.503054778916848,4.891013384321224
Kanchanpur,Punarbas Municipality,13676,12895,61628,28286,33342,4.506288388417666,4.7792167506785574
Kanchanpur,Shuklaphanta Municipality,12120,11316,54379,24948,29431,4.486716171617162,4.805496641922941
Dadeldhura,Alital Rural Municipality,3743,3421,18125,8773,9352,4.842372428533262,5.298158433206665
Dadeldhura,Ajaymeru Rural Municipality,3479,2987,15243,7167,8076,4.381431445817764,5.1031134917977905
Dadeldhura,Amargadhi Municipality,6385,4752,24792,12515,12277,3.882850430696946,5.217171717171717
Dadeldhura,Bhageshwar Rural Municipality,2812,2362,13112,6290,6822,4.662873399715505,5.551227773073666
Dadeldhura,Ganayapdhura Rural Municipality,3360,2788,13655,6158,7497,4.063988095238095,4.897776183644189
Dadeldhura,Nawadurga Rural Municipality,4335,3634,18745,8194,10551,4.324106113033449,5.158227848101266
Dadeldhura,Parashuram Municipality,7494,6559,35748,16833,18915,4.77021617293835,5.450221070285105
Baitadi,Dasharathchanda Municipality,7339,6095,31786,15053,16733,4.331107780351546,5.215094339622642
Baitadi,Dilasaini Rural Municipality,4925,3930,23233,11347,11886,4.7173604060913705,5.911704834605598
Baitadi,Dogadakedar Rural Municipality,4774,3998,23619,10854,12765,4.947423544197738,5.907703851925963
Baitadi,Melauli Municipality,4626,3890,21000,9735,11265,4.539559014267185,5.3984575835475574
Baitadi,Pancheshwar Rural Municipality,3617,2986,17780,8130,9650,4.915675974564556,5.9544541192230405
Baitadi,Patan Municipality,6276,5195,28360,13415,14945,4.518801784576163,5.459095283926853
Baitadi,Purchaudi Municipality,7236,6417,38666,18701,19965,5.3435599778883365,6.02555711391616
Baitadi,Shivanath Rural Municipality,3435,2919,18247,8489,9758,5.312081513828239,6.251113394998287
Baitadi,Sigas Rural Municipality,4367,3652,23479,11153,12326,5.376459812228074,6.42907995618839
Baitadi,Surnaya Rural Municipality,3877,3206,18230,8549,9681,4.7020892442610265,5.686213349968808
Darchula,Apihimal Rural Municipality,1363,1256,7023,3438,3585,5.152604548789435,5.5915605095541405
Darchula,Byas Rural Municipality,2361,2168,10205,4884,5321,4.322321050402372,4.707103321033211
Darchula,Dunhu Rural Municipality,2293,1906,9912,4580,5332,4.322721325774095,5.2004197271773345
Darchula,Lekam Rural Municipality,3045,2645,13638,6520,7118,4.478817733990148,5.156143667296786
Darchula,Mahakali Municipality,6080,4596,24572,12072,12500,4.041447368421053,5.3463881636205395
Darchula,Malikaarjun Rural Municipality,3241,2993,15754,7631,8123,4.86084541808084,5.263615101904444
Darchula,Marma Rural Municipality,3086,2704,15586,7551,8035,5.050550874918989,5.7640532544378695
Darchula,Naugad Rural Municipality,3156,2920,16434,7988,8446,5.2072243346007605,5.6280821917808215
Darchula,Shailyashikhar Municipality,4561,4012,21932,10685,11247,4.808594606445955,5.466600199401794
